NO ./img/monkey.xpm
SO ./img/wall_2.xpm
WE ./img/wall_3.xpm
EA ./img/wall_4.xpm
F 106,12,173
C 255,192,203




        1111111111111111111111111
        100000000110000000000001
        1011000001110000000000001
        1001000000000000000000001
111111111011000001110000000000001
1000000000110000011101111101111111
10000000000000000110000010001
11110111111111011101010010001
11000000110111011100000010001
1000000 0001  100000110S0001001
10000000001  1001101010010001
11000001110111011111011110011
111101111110101111111010001
11111111 1111111 111111111111