NO ./img/test.xpm
SO ./img/south.xpm
WE ./img/east.xpm
EA ./img/west.xpm
F 15,141,173
C 237,173,45



        1111111111111111111111111
        100000000110000000000001
        1011000001110000000000001
        1001000E00000000000000001
111111111011000001110000000000001
1000000000110000011101111101111111
10000000000000000110000010001
11110100000011011101010010001
11000000110111011100000010001
100000000001  100000110000001
10000000001  1001101010010001
11000001110111011111011110011
111101111110101111111010001
11111111 1111111 111111111111