NO ./img/wall_1.xpm
SO ./img/wall_2.xpm
WE ./img/wall_3.xpm
EA ./img/wall_4.xpm
F 50, 168, 82
C 240, 117, 193



        1111111111111111111111111
        100000000110000000000001
        1011000001110000000000001
        1001000000000000000000001
111111111011000001110000000000001
10000001100000111011111011111111
10000000000000000110000010001
11110100000011011101010010001
11000000110111011100000010001
1000N0000001  100000110000001
10000000001  1001101010010001
11000001110111011111011110011
111101111110101111111010001
111 11111 1111111 111111111111

 