NO ./img/north.xpm
SO ./img/south.xpm
WE ./img/east.xpm
EA ./img/west.xpm
F 15,225,173
C 237,173,45

  111111111111111111111111
  100000000000000000000001
  100000000000000000000001
  100000000000000000000001
  100000000000000000000001
  100000000011100000000001
  100000000000100000000001
  100E00000011100000000001
  100000000000000000000001
  100000000000000000000001
  100000000000000000000001
  100000000001000000000001
  100000000000000000000001
  111111111111111111111111