NO ./img/monkey.xpm
SO ./img/wall_2.xpm
WE ./img/wall_3.xpm
EA ./img/wall_4.xpm
F 106,12,173
C 255,192,203

          111111
          100001
          100001
          100001
  111111111000011111111111
  100010000000000000000001
  10001000000E000000010001
  100000000001000000010001
  111111111111111111111111