NO ./img/beach_1.xpm  
SO ./img/beach_2.xpm
WE ./img/beach_3.xpm






EA ./img/beach_4.xpm
F 255,69, 1
C 255,218,244

111111111111111111111111
100000000000000000000001
1000000000000S0000000001
100000000000000000000001
 100000000000000000000001
  100000000011100000000001
  10000000001 100000000001
  100000000011100000000001
  100000000000000000000001
  100000000000000000000001
  100000000000000000000001
  100000000000000000000001
  100000000000000000000001
  111111111111111111111111


