NO ./img/north.xpm
SO ./img/south.xpm
WE ./img/east.xpm
EA ./img/west.xpm
F 130, 118, 99
C 135, 207, 237

111111111111111111111111
100000000000000000000001
100000000000000000000001
100000000000000000000001
 100000000000000000000001
  100000000011100000000001
  10000000001 100000000001
  100000000011100000000001
  100000000000000000000001
  100000000000000000E00001
  100000000000000000000001
  100000000001000000000001
  100000000000000000000001
  111111111111111111111111