NO ./img/beach_1.xpm
SO ./img/beach_2.xpm
WE ./img/beach_3.xpm
EA ./img/beach_4.xpm
F 130, 118, 99
C 135, 207, 237

11111111
10000001
10000001
10000001
10000001
10000001
1000S101
10001001
10000001
10000001
11111111