NO ./img/beach_1.xpm
SO ./img/beach_2.xpm
WE ./img/beach_3.xpm
EA ./img/beach_4.xpm
F 130, 11 8, 99
C 134, 22, 34

1111111111111111111111111111111111111111111111
1E00000000000000000000000000000000000000000001
1111111111111111111111111111111111111111111001
                                          1001
11111111111111111111111111111111111111111 1001
10000000000000000000000000000000000000001 1001
10011111111111111111111111111111111111001 1001
1001                                 1001 1001
1001 1111111111111111111111111111111 1001 1001
1001 1000000000000000000000000000001 1001 1001
1001 1001111111111111111111111111001 1001 1001
1001 1001                       1001 1001 1001
1001 1001 111111111111111111111 1001 1001 1001
1001 1001 100000000000000000001 1001 1001 1001
1001 1001 100111111111111111001 1001 1001 1001
1001 1001 1001             1001 1001 1001 1001
1001 1001 1001  111111111111001 1001 1001 1001
1001 1001 1001  100000000000001 1001 1001 1001
1001 1001 1001  111111111111111 1001 1001 1001
1001 1001 1001                  1001 1001 1001
1001 1001 10011111111111111111111001 1001 1001
1001 1001 10000000000000000000000001 1001 1001
1001 1001 11111111111111111111111111 1001 1001
1001 1001                            1001 1001
1001 100111111111111111111111111111111001 1001
1001 100000000000000000000000000000000001 1001
1001 111111111111111111111111111111111111 1001
1001                                      1001
1001111111111111111111111111111111111111111001
1000000000000000000000000000000000000000000001
1111111111111111111111111111111111111111111111