NO ./img/wall_1.xpm
SO ./img/wall_2.xpm
WE ./img/wall_3.xpm
EA ./img/wall_4.xpm
F 50, 168, 82
C 240, 117, 193



        1111111111111111111111111
        100000000110000000000001
        101100E001110000000000001
        1001000001000000010000001
		111 11111 1111111 111111111
